111111111111111
S00000000000001
010000011111111
011111011111111
011111000000001
E00000011111111
111111111111111